#Example: Large parts of Africa and south east Asia
tropical = {
	491 492 493 494 495 496 497 498 499 500 501 502 503 504 505 506 507 508 509 510 511 512 513 514 515 516 517 518 519 520 521 522 523 524 525 526 527 528 529 530 531 532 533 534 535 536 735 736 737 738 739 740 741 742 743 744 745 746 747 748 749 750 751 752 753 754 794 799 800 1094 1130 1161 1162 1163 1164 1165 1166 1167 1168 1169 1170 1171 1172 1173 1174 1175 1176 1177 1178 1179 1180 1181 1182 1183 1184 1185 1186 1187 1188 1189 1190 1191 1192 1193 1194 1195 1196 1197 1198 1199 1200 1201 1202 1203 1204 1205 1206 1207 1208 1209 1210 1211 1212 1213 1214 1215 1216 1217 1218 1219 1220 1221 1303 1304 1305 1306 1309 1321 1322 1323 1324 1325 1326 1327 1328 1329 1330 1331 1332 1333 1334 1335 1336 1337 1338 1339 1340 1341 1342 1343 1344 1345 1346 1347 1348 1349 1350 1351 1352 1353 1354 1355 1356 1357 1358 1359 1360 1361 1514 1513 1511 1512 1515 1503 1501 1498 1499 1500 1502 1505 1506 1507
    1508 1510 1509 1494 1482 1495 1483 1493 1484 1486 1485 1487 1492 1491 1489 1490 1488 1496
    1301 626 1300 353 963 1319 1320 1318 1079 1080 1469 1644 1084 1086 1006 1308 958 959 1132 1089 1092 1093 1088 1090 1091 1085 1457 1135 1138 1467 1133 1131 1136 1454 1456 
    1137 1468 1455 1134 1453 1459 1307 1460 1461 1462 1310 1463 1466 1311 1312 1313 1458 1465 1314 1315 1316 1317 1464 
    
    721 1153 724 1143 1246 722 1250 719 1154 1249 723 1248 1247 727 1262 726 1259 1258 1257 
    725 1261 1260 787 1263 728 1264 732 733 734 729 730 1256 1254 1255 731 1252 1253 1251 
    
    788 1146 1145 789 793 790 1274 1275 1273 1271 1270 1272 791 792 1267 1268 1269 767 768 765
    763 764 766  776 786 784 785 769 773 775 770 771 772 872 873 874 871 868 869 875
    774 777 778 870 779 782 783 781 780 867 865 866
    
}

arid = {
	335 336 337 338 339 340 341 342 343 344 345 346 347 348 349	350 351 352
	651	652	653	654	655	656	657	658	659	660	661	662	663	664	665	666 671 672	1147 1148 1149 1150 1151 667 1245 1144 1276 1281 1284 674 1283 676 1285 844 678 1287 1288 1286 677 679 1289 1298 847 1297 861 864 857 856 855 863 819 
	823 818 816 1392 817 815 1394 3059 3060 3030 3062 3061 3063 3058 3056 3057 879 877 878 824
    1290 1242 1244 1243 1296 846 842 
}

arctic = {
	1 2 3 4 5 6 7 8 9 10 11 12 13 14 15 16 17 18 19 20
	580 581 582 583 584 586 587 589 579 588 585 590 591 593 592 595 594 1142 1139 1140 1141 1591 1592 1574 1575 1577 1576 1580 1578 1581 1579 1582 1586 1584 1583 1589 1585 1587 1588
    32 30 31 33
}

mild_winter = {
	282 283 284 285 286 287 288 289 290 291 292
	327 328 329 330 331 332 333 334
	360 361 362 363 364 365 366 367 368
	596 597 598 599 600 601 602 615 621 622 623 755 756 757 758 759 760
	603	604	605	606	607	608	609	610	611	612	613	614	616	617	618	619	620 627	628	629	630	631	632	633	634	635	637	638	639	640	641
	642	643	644	645	646	647	648	649	650	
	624 625 626 636 667 670
	369	370	371	372	373	374	375	376	377	378	379	380	381	382	383	384	385	386	387	388	389	390	391	392	393	394	395	396	397	398	399	400
	401	402	403	404	405	406	407	408	409	410	411	412	413	414	417	418	419	420	421	422	423	424	425	426	427	428	429	430 482	483	484	485
	486	487	488	489	490
	761	762	763	764	765	766	767	768	769	770	771	772	773	774	775	776	777	778	779	780	781	782	783	784	785	786	787 	
	793	795	796	797	798	799	800	801	802	803	804	805	806	807	808	809	810	811	812	813	814	819	820	821	822	
	825	826	827	828	829	830	831	832	833	835	836	837	838	839	840	841	842	843	844	845	846	847	848	849	850	851	852	853	854	855	856
	857	858	859	860	861	862	863	864	865	866	867	868	869	870	871	872	873	874	875	876
	683 684 685 686 687 688 689 690 691 692 693 694 695 696 697 698 699 700 701 702 703 704 705 706 707 708 709 710 711 712 713 714 715 716 717 718 
	
	1222 1223 1224 1225 1226 1227 1228 1229 1230 1231 1232 1233 1234 1235 1236 1237 1238 1239 1278 1292 1293 1294 1295 1296 1297 1298 1299 1302 
    3066 1266 1265 3067 3065 1362 3064 1363 1364 3055 1481 3054 3053 3052 3051 3039 3040 1369 3044 3045 1365 3046 1367 1366 3047 3048 1368 3041 1480 3018 3043 3036 1370 1479 1375 3038 3037 3021 3017 3012 3016 3023 3024 3026 3020 3034 3049 1377 3050 1478 1376 1372 1477 3033 1373 3032 1378 3031 1476 1379 1380 1381 1395 1474 1382 1383 1384 1385 1386 1473 1388 1389 1472 1471 1387 1470 1391 1390
    3035 1371 3042 3015 3028 3019 3027 3025 3022 1393 3011 3014 1374 3013 415 416 359 358 1518
}

normal_winter = {
	66 67 68 69 70 71 72 73 74 75 76 77 78 79 80 81 82 83 84 85 86 87 88 89 90 91 92 93 94 95 96 97 98 99
	100 101 102 103 104 105 106 107 108 109 110 111 112 113 114 115 116 117 118 119 120 121 122 123 124 125 126 127 128 129 130 131 132 133 134 135 136 137 138 139 140 141 142 143 144 145 146 147 148 149
	150 151 152 153 154 155 156 157 158 159 160 161 162 163 164 165 166 167 168 169 170 171 172 173 174 175 176 177 178 179 180 181 182 183 184 185 186 187 188 189 190 191 192 193 194 195 196 197 198 199
	200 201 202 203 204 205 206 207 208 209 210 211 212 213 214 215 216 217 218 219 220 221 222 223 224 225 226 227 228 229 230 231 232 233 234 235 236 237 238 239 240 241 242 243 244 245 246 247 248 249
	250 251 252 253 254 255 256 257 258 259 260 261 262 263 264 265 266 267 268 269 270 271 272 273 274 275 276 277 278 279 280 281 293 294 295 296 297 298 299
	300 301 302 303 304 305 306 307 308 309 310 311 312 313 314 315 316 317 318 319 320 321 322 323 324 325 326 354 355 357
	431	432	433	434	435	436	437	438	439	440	441	442	443	444	445	446	447	448	449	450	451	452	453	454	455	456	457	458	459	460	461	462	463	464	465	466	467
	468	469	470	471	472	473	474	475	476	477	478	479	480	481
	537	538	539	540	541	542	543	544	545	546	547	548	549	550	551	552	553	554	555	556	557	558	559	560	561	562	563	564	565
	660 674	675	676	677	678	679	680	681	682
	
	1282 1283 1285 1286 1287 1288 1289 1290 1291 1517
    
    1403 1404 1405 1400 1407 1409 1408 1410 1411 1413 1412 1416 1417 1415 1401 1406 1402 1414 834 1399 1397 1398 1396 1418
}

severe_winter = {
	1 2 3 4 5 6 7 8 9 10 11 12 13 14 15 16 17 18 19 20
	21 22 23 24 25 26 27 28 29 30 31 32 33 34 35 36 37 38 39 40 41 42 43 44 45 46 47 48 49
	50 51 52 53 54 55 56 57 58 59 60 61 62 63 64 65 356
	566	567	568	569	570	571	572	573	574	575	576	577	578
	579 580 581 582 583 584 585 586 587 588 589 590 591 592 593 594 595
	
	1139 1140 1141 1142 1574 1575 1576 1577 1578 1579 1580 1581 1582 1583 1584 1585 1586 1587 1588 1589 1590 1591 1592 3010
}

impassable = {
	117 # Isle of Faces
	672 # Southern Bone Mountains 
	675 # Central Bone Mountains
	681 # Northern Bone Mountains
	807 # Southern Mountains of the Morn
	812 # Eastern Mountains of the Morn 
	813 # Northern Mountains of the Morn
	843 # Northern Great Sand Sea
	845 # Southern Great Sand Sea
	849 # The Shrinking Sea
	1504 # Ulthos Jungle
	1418 # Ibben Mountain
	1419 # Ghis Mountain Wasteland
	1420 # Lhazar Wasteland
	1421 # Yunkai Wasteland
	1422 # Astapor Wasteland
	1425 # Demon Road Wasteland
	1447 # Lorath Wasteland
	1450 # Braavos Wasteland
	1529 # The North Wasteland
	1532 # Vale Wasteland
	1536 # Vale Wasteland
	1537 # Westerland Wasteland
	1538 # Westerland Wasteland
	1543 # Westerland Wasteland
	1544 # Dorne Wasteland
	1559 # Dorne Wasteland
	1565 # Stormlands Wasteland
	
	801 # Eastern Shadow Mountains
	804 # Western Shadow Mountains
	
	823 # The Grey Waste
    
    469 # Super Secret Land
    
    # Howling Mountains
    687 686 685 688 684 839 840 841
    
    # Red Waste
    657 651
    
    815 1394
}

mild_monsoon = {
	
}

normal_monsoon = {
	
}

severe_monsoon = {
	
}

equator_y_on_province_image = 656