westeros = {
	1 2 3 4 5 6 7 8 9 10 11 12 13 14 15 16 17 18 19 20 21 22 23 24 25 26 28 29 30 31 32 33 34 35 36 37 38 39 40 41 42 43 44 45 46 47 48 49 50 51 52 53 54 55 56 57 58 59 60 61 62 63 64 65 66 67 68 69 70 71 72 73 74 75 76 77 78 79 80 81 82 83 84 85 86 87 88 89 90 91 92 93 94 95 96 97 98 99 100 101 102 103 104 105 106 107 108 109 110 111 112 113 114 115 116 117 118 119 120 121 122 123 124 126 127 128 129 130 131 132 133 134 135 136 137 138 139 140 141 142 143 144 145 146 147 148 149 150 151 152 153 154 155 156 157 158 159 160 161 162 163 164 165 166 167 168 169 170 171 172 173 174 175 176 177 178 179 180 181 182 183 184 185 186 187 188 189 190 191 192 193 194 195 196 197 198 199 200 201 202 203 204 205 206 207 208 209 210 211 212 213 214 215 216 217 218 219 220 221 222 223 224 225 226 227 228 229 230 231 232 233 234 235 236 237 238 239 240 241 242 243 244 245 246 247 248 249 250 251 252 253 254 255 256 257 258 259 260 261 262 263 264 265 266 267 268 269 270 271 272 273 274 275 276 277 278 279 280 281 282 283 284 285 286 287 288 289 290 291 292 293 294 295 296 297 298 299 300 301 302 303 304 305 306 307 308 309 310 311 312 313 314 315 316 317 318 319 320 321 322 323 324 325 326 327 328 329 330 331 332 333 334 335 336 337 338 339 340 341 342 343 344 345 346 347 348 349 350 351 352 354 355 356 357 737 1139 1140 1141 1142 1517 1576 1580 1584  1589 1590 1529 1532 1536 1537 1538 1543 1544 1559 1565 3010 
    
    2000 2001 2002 2003 2004 2005 2006 2007 2008 2009 2010 2011 2012 2013 2014 2015 2016 2017 2018 2019 2020 2021 2022 2023 2024 2025 2026 2027 2028 2029 2030 2031 2032 2033 2034 2035 2036 2037 2038 2039 2040 2041 2042 2043 2044 2045 2046 2047 2048 2049 2050 2051 2052 2053 2054 2055 2056 2057 2058 2059 
}

west_essos = {
	1518 358 360 365 362 361 364 359 363 367 366 369 370 373 371 372 374 376 398 397 399 368 416 415 404 420 422 424 425 400 403 401 402 762 417 419 418 483 484 485 761 598 690 537 538 689 421 423 426 427 488 489 487 486 490 413 412 411 410 405 428 429 430 414 482 396 377 375 378 379 380 395 394 393 381 382 383 392 386 385 384 388 387 451 452 391 390 450 454 453 457 459 389 406 409 408 407 458 461 462 463 464 465 466 468 467 470 456 460 445 471 446 447  475 474 448 455 432 449 434 435 441 433 472 440 473 443 444 442 481 477 437 476 478 438 431 436 439 480 479 544 548 543 550 546 547 545 1447 1450
}

dothraki_sea = {
    551 557 560 559 558 552 549 542 539 540 541 696 695 694 693 697 555 553 554 556 565 564 562 566 563 561 573 572 571 568 569 567 705 702 706 570 703 707 713 712 714 709 715 708 574 710 711 717 716 718 578 576 577 575 660 659 661 699 701 700 698 645 658 644 704 647 643 
}

ibben = {
    590 593 592 591 594 595 588 589 587 586 585 584 583 582 579 580 581 1418
}

central_essos = {
    635 632 631 633 618 620 619 617 636 625 1241 624 1240 599 1223 1224 1222 602 601 1226 1225 1227 603 600 604 605 691 692 596 760 759 755 597 756 757 758 608 606 1230 1228 637 1229 607 1231 639 630 634 640 638 646 648 649 615 610 1232 1233 611 1235 609 1234 629 616 1239 613 1236 612 628 1237 614 1238 627 622 621 623 663 1150 1149 1148 1147 662 665 664 1243 1242 1244 666 1276 1245 667 1151 1144 1152 720 657 651 652 642 641 650 653 656 654 655 1419 1420 1421 1422 1425
}

faros = {
    721 1153 724 1143 1246 722 1250 719 1154 1249 723 1248 1247 727 1262 726 1259 1258 1257 725 1261 1260 787 1263 728 1264 732 733 734 729 730 1256 1254 1255 731 1252 1253 1251 
}

east_essos = {
    788 1146 1145 789 793 790 1274 1275 1273 1271 1270 1272 791 792 1267 1268 1269 767 768 765 763 764 766 776 786 784 785 769 773 775 770 771 772 872 873 874 871 868 869 875 774 777 778 870 779 782 783 781 780 867 865 866 669 1278 668 1279 673 1280 1277 670 671 1281 1284 674 1282 1283 1285 676 677 1286 1288 1287 678 1290 679 1289 680 1291 682 1295 683 1292 1293 1294 844 1298 1302 842 846 847 861 1296 1297 1299 848 851 850 853 837 838 860 858 859 876 852 841 840 839 684 688 687 686 685 835 836 855 854 864 857 856 863 862 822 821 820 672 675 681 843 845 849
}

thousand_islands = {
    1403 1404 1405 1400 1407 1409 1408 1410 1411 1413 1412 1416 1417 1415 1401 1406 1402 1414 834 1399 1397 1398 1396
}

distant_essos = {
    824 832 878 819 877 818 1392 879 817 1477 1378 1476 1379 1380 831 830 829 833 828 827 826 1395 825 1471 1381 1387 1470 1391 1390 1473 1388 1389 1472 1382 1474 1383 1384 1385 1386 815 1394 816 1372 1376 1371 3014 3015 814 3018 3021 3020 3017 3016 1373 3019 3011 3012 3013 1393 1478 1377 1375 1479 1367 1370 1365 1366 1368 1480 1369 811 809 810 808 1481 1364 1363 806 805 797 803 802 1362 798 796 1266 1265 795 801 804 807 812 813 823 1374 3022 3023 3024 3025 3026 3027 3028 3029 3030 3031 3032 3033 3034 3035 3036 3037 3038 3039 3040 3041 3042 3043 3044 3045 3046 3047 3048 3049 3050 3051 3052 3053 3054 3055 3056 3057 3058 3059 3060 3061 3062 3063 3064 3065 3066 3067
}

summer_islands = {
	 491 494 495 493 498 497 496 492 501 500 499 502 503 508 506 509 507 505 504 514 516 515 513 512 511 510 517 521 518 519 522 520 529 524 525 526 523 527 528 530 531 532 533 535 536 534 
}

naath = {
    626 1300 1301
}

sothoyros = {
	 1469 748 742 743 744 747 749 750 751 752 753 754 1319 746 1320 1318 353 963 1187 740 741 1221 738 1130 1464 739 1317 1316 1219 1305 1458 735 1315 736 1314 1465 1311 1312 1466 1220 1313 1166 1203 1457 1209 1162 1306 1207 1085 959 958 1088 1006 1206 1308 1208 1309 1199 1079 1084 1205 1080 1081 1132 1168 1086 1304 1089 1094 1090 1093 1092 1165 1215 1137 1091 1216 1468 1188 1163 1463 1462 1217 1189 1310 1461 1460 1307 1459 1303 1218 1213 1214 1453 1134 1164 1202 1135 1456 1455 1210 1211 1212 1197 1204 1138 1167 1133 1467 1161 1136 1131 1200 1169 1184 1175 1176 1201 1198 1454 
}

ulthos = {
	799 800 1515 1512 1322 1321 1323 1324 1325 1326 1327 1330 1329 1328 1513 1331 1332 1333 1337 1334 1335 1341 1342 1340 1339 1336 1338 1509 1510 1343 1344 1508 1345 1347 1507 1349 1506 1346 1348 1505 1350 1502 1500 1351 1499 1352 1353 1498 1354 1501 1355 1503 1357 1358 1359 1356 1514 794 1360 1361 1511 1494 1495 1482 1493 1483 1485 1486 1487 1484 1497 1492 1491 1489 1490 1488 1496 1504
}

island_check_provinces = {
}

new_world = {
}
