forests_of_ifeqevron_group = {
	575 572 571 568 567 563 566
}

omber_group = {
	561 569 559 558 557 551 
}

seven_kingdoms_group = {
	71 68 74 72 73 69 70 67 66 61 46 45 43 40 41 42 36 44 57 58 59 62 65 63 64 60 56 55 54 49 47 39 34 35 37 38 48 23 356 22 21 24 27 25 28 50 53 52 51 29 26 33 3010
	1529 1530 1531
	298 300 297 295 229 228 227 223 222 226 230 231 232 233 234 220 225 224 203 204 205 206 207 209 210 211 212 208 213 214 215 217 216 218 219 221 305 117
	311 315 316 317 325 319 322 324 326 323 321 320 313 312 302 293 294 301 304 299 296 314 303 318 310 309 308 307 1565
	158 159 157 156 155 154 151 152 153 160 161 162 357 
	134 145 146 147 148 144 140 135 133 123 124 129 130 125 126 121 118 119 120 122 128 132 131 137 141 138 139 143 142 149 150 136 127 1532 1536
	291 290 289 287 286 285 282 272 274 283 284 288 281 275 273 271 276 280 278 279 270 260 269 277 267 265 266 241 240 235 238 236 237 239 242 243 246 245 256 268 257 258 259 306 255 253 251 250 247 248 249 254 252 263 261 264 262 292
	244 200 199 198 197 185 186 190 189 195 196 192 191 180 187 188 183 182 184 179 176 174 175 178 170 169 168 171 173 172 165 166 164 163 167 1517 1537 1538 1543
	202 194 354 193 201 116 114 112 181 177 110 111 355 113 115 109 108 107 97 106 104 105 103 102 100 101 99 86 85 87 88 90 91 96 93 92 94 84 82 80 81 79 76 77 78 83 89 75
	95 98
	327 332 335 336 337 333 328 331 334 339 338 340 341 344 343 345 346 349 342 330 329 347 350 351 352 348
	1544 1559
}

# Westeros Wastelands
westeros_wastelands = {
	117 1529 1532 1536 1537 1538 1543 1544 1559 1565
}

essos_west_wastelands = {
	1447 1450 690 691 692 693 689 539 540 541
}

essos_central_wastelands = {
	1418 1419 1420 1421 1422 1425
}

essos_east_wastelands = {
	672 675 681 807 812 813 843 845 849 685 686 688 687 841 840 839 684 801 804 823
}

ulthos_wastelands = {
	1504
}

kingsroad = {
	304 301 294 295 229 226 225 210 205 206 108 97 94 84 83 78 71 70 66 61 58 57 49 47 48 356 24 19 1589 17
}

goldroad = {
	183 188 187 191 195 196 194 202 203 224 226
}

valyrian_peninsula = {
	596 760 759 755 597 756 757 758 601 602 1226 1225 1227 599 1223 1224 1222 598 761
}